111111111111111111111111
10P010001000010000000101
100001001100000000000001
100000001111100000000001
100000000001111111000001
111000000000000010000001
111111111000000000000001
1E0000000000000010000001
111111111111111111111111