111111111111111111111111
10P01C001C000100000001C1
100CC10011000000C0000001
10000000111110000000C001
100000000001111111000001
11100000000000C010C00001
1111111110000000C000P001
1E000C000000000010000001
111111111111111111111111