11111111111111111111111111111111111111111111111111111111111111111111111111111111111111111111111111111111111111111111111111111111111111111111111
10P01C001C000100000001C111111111111111111111111111111111111111111111111111111111111111111111111111111111111111111111111111111111111111111111111
100CC10011000000C000000111111111111111111111111111111111111111111111111111111111111111111111111111111111111111111111111111111111111111111111111
10000000111110000000C00111111111111111111111111111111111111111111111111111111111111111111111111111111111111111111111111111111111111111111111111
10000000000111111100000111111111111111111111111111111111111111111111111111111111111111111111111111111111111111111111111111111111111111111111111
11100000000000C010C0000111111111111111111111111111111111111111111111111111111111111111111111111111111111111111111111111111111111111111111111111
1111111110000000C000000111111111111111111111111111111111111111111111111111111111111111111111111111111111111111111111111111111111111111111111111
1E000C00000000001000000111111111111111111111111111111111111111111111111111111111111111111111111111111111111111111111111111111111111111111111111
11111111111111111111111111111111111111111111111111111111111111111111111111111111111111111111111111111111111111111111111111111111111111111111111