1111111111111111111111111111111111111111111111111111111111111
10010000000C1111111111111111111111111111111111111111111111111
1000011111001111111111111111111111111111111111111111111111111
1P0011E000001111111111111111111111111111111111111111111111111
1111111111111111111111111111111111111111111111111111111111111